# lvlwidth 21
# lvlheight 25

# startleveldata
0 0 0 0 0 0 0 0 0 113 21 113 0 0 0 0 0 0 0 0 0 
0 107 100 100 100 100 100 100 100 106 0 105 100 100 100 100 100 100 100 108 0 
0 101 0 0 0 0 0 0 0 0 0 0 0 0 0 0 0 0 0 101 0 
0 101 0 120 0 113 0 111 100 108 2 107 100 112 0 113 0 120 0 101 0 
0 101 0 0 0 101 0 0 0 101 0 101 0 0 0 101 0 0 0 101 0 
0 101 0 111 100 106 0 113 0 110 0 110 0 113 0 105 100 112 0 101 0 
0 101 0 0 0 0 0 101 0 0 0 0 0 101 0 0 0 0 0 101 0 
0 101 0 120 0 111 100 130 100 112 0 111 100 130 100 112 0 120 0 101 0 
0 101 0 0 0 0 0 0 0 0 0 0 0 0 0 0 0 0 0 101 0 
0 105 100 108 0 113 0 111 100 100 100 100 100 112 0 113 0 107 100 106 0 
0 0 0 101 0 101 0 0 0 0 10 0 0 0 0 101 0 101 0 0 0 
111 100 100 106 0 105 112 0 107 112 1 111 108 0 111 106 0 105 100 100 112 
20 0 0 0 0 0 0 0 101 11 12 13 101 0 0 0 0 0 0 0 20 
111 133 100 112 0 111 112 0 105 100 100 100 106 0 111 112 0 111 100 133 112 
0 101 0 0 0 0 0 0 0 0 0 0 0 0 0 0 0 0 0 101 0 
0 101 0 120 0 107 112 0 111 100 100 100 112 0 111 108 0 120 0 101 0 
0 101 0 0 0 101 0 2 0 0 4 0 0 0 0 101 0 0 0 101 0 
0 105 133 112 0 110 0 111 100 100 133 100 100 112 0 110 0 111 133 106 0 
0 0 101 0 0 0 0 0 0 0 101 0 0 0 0 0 0 0 101 0 0 
0 0 101 0 111 112 0 111 108 0 101 0 107 112 0 111 112 0 101 0 0 
107 100 106 0 0 0 0 0 101 0 101 0 101 0 0 0 0 0 105 100 108 
101 0 0 0 111 100 112 0 110 0 110 0 110 0 111 100 112 0 0 0 101 
101 3 120 0 0 0 0 0 0 0 0 0 0 0 0 0 0 0 120 0 101 
101 0 0 0 107 100 100 100 100 108 0 107 100 100 100 100 108 0 0 0 101 
105 100 100 100 106 0 0 0 0 110 21 110 0 0 0 0 105 100 100 100 106 
# endleveldata

